10
10
xxxxxxxxxx
xHHHHH...x
xHHx.x.x.x
x.x......x
x...xxx..x
x..x.....x
x..h.x...x
x.xxxx...x
x......s.x
xxxxxxxxxx
