10
10
xxxxxxxxxx
x........x
x.x.xx.x.x
x.x..x.x.x
x...H....x
x.x.xx.x.x
x....x.x.x
x.xx.x.x.x
xh..s....x
xxxxxxxxxx
