10
10
xxxxxxxxxx
x........x
x........x
x........x
x...H....x
x........x
x..h.....x
x........x
x......s.x
xxxxxxxxxx